21 0 0 19 20
 XXXXXXXXXXXXXXXXXXXX
        X       X   X
X XXXXX X X XXXXX XXX
X   X   X X X       X
X XXXXX X XXX XXX XXX
X X X     X X X     X
XXX X XXXXX X X XXXXX
X       X X   X X   X
X X XXXXX XXXXX XXX X
X X X     X         X
XXX X XXXXX XXXXX XXX
X   X X X X   X   X X
X X X X X X X XXX X X
X X X     X X   X   X
XXX XXXXX XXX XXXXXXX
X X   X         X X X
X X XXXXX X X XXX X X
X       X X X       X
X X XXX XXXXX XXX XXX
X X X       X   X    
XXXXXXXXXXXXXXXXXXXXX